thus : así
unflinching : firme
pace : paso
quench (to -) : apagar
heavenly : celestial
sorrow : dolor
thirst : sed
detour : desviado
anew : nuevamente
endeavor : esfuerzo
blameless : irreprochable
holy : santo
blissful : dichoso
worthy : digno
attain (to -) : lograr
asleep : dormido
dwell (to -) : morar
innermost : más profundo
relieve (to -) : aliviar
stillness : quietud
vessel : vaso
trickle : goteo
melt : fusion
twinkle (to -) : centellear
restless : inquieto
joy : alegria
shady : umbroo
limb : miembro
grove : bosquecillo
bluish : azulado
fig : higo
wandering : errante
bearer : portador
herd : manada
sly : furtivo
wicked : malo
conceited : presumido
will : voluntad
lofty : alto
supple : suave
glow (to -) : resplandecer
brow:frente
intake:admision
inwardly:interiormente
surprised:sorprendido
intake:admision
