crouch (to -) : agacharse
thorn : espina
drip (to -) : gotear
stiff : tieso
prick : pincharse
smart : punzada
upright : derecho
breathing : respiración
heartbeat : latido del corazón
lessen : disminuir
hardly : casi nada
self-denial : sacrificio
heron : garza
hunger : hambre
lay on : extender sobre
sandy : arenoso
shore : orilla
slip into : entrar en
swell (to -) : hincharse
mingle (to -) : mezclar
carcass : cadáver
reawake : volver a despertar
endeavor : esfuerzo
beg (to -) : rogar
further : fomentar
appraise (to -) : estimar
inn : posada
fasting : ayuno
folly : tontería
bowl : cuenco
dwell (to -) : morar
drunkard : borrachín
womb : útero
wood : bosque
upward : hacia arriba
worthy : digno
attain (to -) : lograr
deceive (to -) : engañar
utterance : pronunciación
dreadful : terrible
grief : pesar
mock (to -) : burlarse
thirst : sed
bliss : beatitud
