pull out : extraer
silly : tonto
buckle : hebilla
cart : carreta
gutter : canal
angry : enojado
ungrateful : ingrato
chamberland : camarero
frown : ceño
pluck : tirón
bore (to -) : perforar
linger (to -) : demorarse
burst : ráfaga
throat : garganta
choke (to -) : ahogar
faint (to -) : desmayarse
girdle : faja
tomb : tumba
bitter : amargo
pang : punzada
fierce : feroz
bridegroom : novio
maiden : doncella
dawn : alba
mist : llovizna
blossom : florecer
ebb away : ir desapareciendo
pity : piedad
selfish : egoísta
walk away : andar sin prisa
lead out of : llevar fuera
fond of : amante
soar (to -) : elevarse
hill : colina
hawthorn : espino
scent : olor
chariot : carro
dear : querido
lifeblood : alma
pierce (to -) : penetrar
stain : mancha
dare to : osar
bud : capullo
chill : frío
fan : abanico
dove : paloma
beneath : abajo
scythe : guadaña
mower : segador
meadow : pasto
daffodil : narciso
mermaid : sirena
shake (to -) : sacudir
foam : espuma
grove : bosquecillo
oak : roble
outright : sincero
daisy : margarita
flutter : vibración
lizard : lagarto
weep (to -) : llorar
throng : multitud
gay : alegre
stringed : de cuerda
pearl : perla
heed : atención
clasp : broche
lean down : recostarse
dawn : alba
sorrow : dolor
pale : pálido
hyacinth : jacinto
wretched : infeliz
nightingale : ruiseñor
nest : nido
